CREATE TABLE `open_076_ao.ods_d_zb_cus_ds_label_all_user`(
AREA_NO	string comment '用户归属地市',
DEVICE_NUMBER	string,
USER_ID	string,
KD_BILLING_BANDWIDTH	double,
KD_CUST_ID	string,
KD_IS_VALID	string,
KD_SERVICE_TYPE	string commen,
KD_SERVICE_SUB_TYPE	string,
KD_USER_STATUS	string,
KD_INNET_LENGTH	double,
KD_INNET_DATE	string,
IS_THIS_DEV	string,
IS_THIS_MONTH_DEV	string,
KD_CHANNEL_TYPE	string,
PR_R_01	string,
KD_COMB_SUB_TYPE	string,
KD_MOBILE_NUMBER1	string,
KD_MOBILE_NUMBER2	string,
KD_MOBILE_NUMBER3	string,
KD_MOBILE_USER_ID1	string,
KD_MOBILE_USER_ID2	string,
KD_MOBILE_USER_ID3	string,
KD_COMB_FX_USER_ID	string,
KD_COMB_FX_NUMBER	string
)  
  
COMMENT '[]'
PARTITIONED BY(MONTH_ID STRING COMMENT '月份分区',DAY_ID STRING COMMENT '日分区')
ROW FORMAT DELIMITED FIELDS TERMINATED BY '\u0001'
NULL DEFINED AS ''
STORED AS RCFILE;"